1.300000000000000000e+01
1.600000000000000000e+01
1.300000000000000000e+01
1.600000000000000000e+01
1.300000000000000000e+01
1.600000000000000000e+01
1.300000000000000000e+01
2.200000000000000000e+01
1.300000000000000000e+01
2.200000000000000000e+01
1.300000000000000000e+01
2.200000000000000000e+01
1.600000000000000000e+01
2.200000000000000000e+01
1.400000000000000000e+01
1.300000000000000000e+01
1.600000000000000000e+01
1.300000000000000000e+01
1.600000000000000000e+01
1.300000000000000000e+01
1.600000000000000000e+01
1.300000000000000000e+01
1.600000000000000000e+01
2.200000000000000000e+01
1.300000000000000000e+01
2.200000000000000000e+01
1.300000000000000000e+01
2.200000000000000000e+01
1.300000000000000000e+01
2.200000000000000000e+01
1.300000000000000000e+01
2.200000000000000000e+01
2.200000000000000000e+01
1.600000000000000000e+01
2.300000000000000000e+01
1.600000000000000000e+01
2.300000000000000000e+01
1.600000000000000000e+01
1.300000000000000000e+01
1.600000000000000000e+01
1.300000000000000000e+01
1.300000000000000000e+01
1.600000000000000000e+01
1.300000000000000000e+01
2.300000000000000000e+01
1.600000000000000000e+01
2.300000000000000000e+01
1.300000000000000000e+01
1.500000000000000000e+01
1.300000000000000000e+01
1.600000000000000000e+01
1.300000000000000000e+01
1.600000000000000000e+01
1.300000000000000000e+01
2.300000000000000000e+01
1.500000000000000000e+01
1.300000000000000000e+01
1.300000000000000000e+01
1.400000000000000000e+01
2.300000000000000000e+01
1.300000000000000000e+01
1.300000000000000000e+01
1.300000000000000000e+01
1.300000000000000000e+01
2.300000000000000000e+01
1.600000000000000000e+01
1.300000000000000000e+01
1.300000000000000000e+01
1.600000000000000000e+01
2.300000000000000000e+01
1.300000000000000000e+01
1.300000000000000000e+01
2.300000000000000000e+01
1.600000000000000000e+01
1.400000000000000000e+01
2.300000000000000000e+01
2.300000000000000000e+01
1.300000000000000000e+01
1.600000000000000000e+01
1.300000000000000000e+01
